卖出 到账 | 卖出 到账 卖出 到账 卖出 到账 卖出 到账
卖出 否定 到账 | 卖出 否定 到账 卖出 否定 到账 卖出 否定 到账 卖出 否定 到账
账户 注销 | 账户 注销 账户 注销 账户 注销 账户 注销
验证码 收不到 | 验证码 收不到 验证码 收不到 验证码 收不到 验证码 收不到

资产 证明 | 资产 证明 资产 证明 资产 证明 资产 证明
联系方式 无效 | 联系方式 无效 联系方式 无效 联系方式 无效 联系方式 无效
定投 终止 | 定投 终止 定投 终止 定投 终止 定投 终止

弘钱包 收益 ^ 更新 | 弘钱包 收益 弘钱包 收益 弘钱包 收益 弘钱包 收益
弘运宝 收益 ^ 更新 | 弘运宝 收益 弘运宝 收益 弘运宝 收益 弘运宝 收益

余额 理财 | 余额 理财 余额 理财 余额 理财 余额 理财






余额宝 升级 | 余额宝 升级 余额宝 升级 余额宝 升级 余额宝 升级
余额宝 明细 | 余额宝 明细 余额宝 明细 余额宝 明细 余额宝 明细
余额宝 绑定 ^ 未绑定 奖励 卡券 红包 | 余额宝 绑定 余额宝 绑定 余额宝 绑定 余额宝 绑定
余额宝 解绑 | 余额宝 解绑 余额宝 解绑 余额宝 解绑 余额宝 解绑
余额宝 否定 绑定 ^ 奖励 卡券 红包 | 余额宝 否定 绑定 余额宝 否定 绑定 余额宝 否定 绑定 余额宝 否定 绑定
余额宝 存入 | 余额宝 存入 余额宝 存入 余额宝 存入 余额宝 存入
余额宝 买入 | 余额宝 买入 余额宝 买入 余额宝 买入 余额宝 买入
余额宝 买入 爱理财 | 余额宝 买入 爱理财 余额宝 买入 爱理财 余额宝 买入 爱理财 余额宝 买入 爱理财
余额宝 买入 弘运宝 | 余额宝 买入 弘运宝 余额宝 买入 弘运宝 余额宝 买入 弘运宝 余额宝 买入 弘运宝
余额宝 买入 弘钱包 | 余额宝 买入 弘钱包 余额宝 买入 弘钱包 余额宝 买入 弘钱包 余额宝 买入 弘钱包

余额宝 未绑定 红包 | 余额宝 未绑定 红包 余额宝 未绑定 红包 余额宝 未绑定 红包 余额宝 未绑定 红包
余额宝 绑定 否定 红包 | 余额宝 绑定 否定 红包 余额宝 绑定 否定 红包 余额宝 绑定 否定 红包 余额宝 绑定 否定 红包
余额宝 未绑定 卡券 | 余额宝 未绑定 卡券 余额宝 未绑定 卡券 余额宝 未绑定 卡券 余额宝 未绑定 卡券
余额宝 绑定 否定 卡券 | 余额宝 绑定 否定 卡券 余额宝 绑定 否定 卡券 余额宝 绑定 否定 卡券 余额宝 绑定 否定 卡券
余额宝 未绑定 奖励 | 余额宝 未绑定 奖励 余额宝 未绑定 奖励 余额宝 未绑定 奖励 余额宝 未绑定 奖励
余额宝 绑定 否定 奖励 | 余额宝 绑定 否定 奖励 余额宝 绑定 否定 奖励 余额宝 绑定 否定 奖励 余额宝 绑定 否定 奖励
余额宝 未绑定 | 余额宝 未绑定 余额宝 未绑定 余额宝 未绑定 余额宝 未绑定

余额宝 同步 | 余额宝 同步 余额宝 同步 余额宝 同步 余额宝 同步
余额宝 同步 取消 | 余额宝 同步 取消 余额宝 同步 取消 余额宝 同步 取消 余额宝 同步 取消
余额宝 同步 否定 | 余额宝 同步 否定 余额宝 同步 否定 余额宝 同步 否定 余额宝 同步 否定

支付宝 登录 | 支付宝 登录 支付宝 登录 支付宝 登录 支付宝 登录
支付宝 否定 登录 | 支付宝 否定 登录 支付宝 否定 登录 支付宝 否定 登录 支付宝 否定 登录
支付宝 绑定 ^  奖励 卡券 红包 银行卡 | 支付宝 绑定 支付宝 绑定 支付宝 绑定 支付宝 绑定
支付宝 否定 绑定 ^  奖励 卡券 红包 银行卡 | 支付宝 否定 绑定 支付宝 否定 绑定 支付宝 否定 绑定 支付宝 否定 绑定
支付宝 授权      | 支付宝 授权 支付宝 授权 支付宝 授权 支付宝 授权
支付宝 授权 否定 | 支付宝 授权 否定  支付宝 授权 否定  支付宝 授权 否定  支付宝 授权 否定
支付宝 解绑 | 支付宝 解绑 支付宝 解绑 支付宝 解绑 支付宝 解绑

支付宝 同步 | 支付宝 同步 支付宝 同步 支付宝 同步 支付宝 同步
支付宝 同步 取消 | 支付宝 同步 取消 支付宝 同步 取消 支付宝 同步 取消 支付宝 同步 取消
支付宝 同步 否定 | 支付宝 同步 否定 支付宝 同步 否定 支付宝 同步 否定 支付宝 同步 否定




银行卡 买入 | 银行卡 买入 银行卡 买入 银行卡 买入 银行卡 买入